rryyWWss	White
rryyWWSs	White
rryyWWSS	White
rryyWwss	White(seed)
rryyWwSs	White
rryyWwSS	White
rryywwss	Purple
rryywwSs	Purple
rryywwSS	Purple
rrYyWWss	Yellow
rrYyWWSs	Yellow
rrYyWWSS	Yellow
rrYyWwss	White
rrYyWwSs	White
rrYyWwSS	White
rrYywwss	Purple
rrYywwSs	Purple
rrYywwSS	Purple
rrYYWWss	Yellow(seed)
rrYYWWSs	Yellow
rrYYWWSS	Yellow
rrYYWwss	Yellow
rrYYWwSs	Yellow
rrYYWwSS	Yellow
rrYYwwss	White
rrYYwwSs	White
rrYYwwSS	White
RryyWWss	Red
RryyWWSs	Pink
RryyWWSS	White
RryyWwss	Red
RryyWwSs	Pink
RryyWwSS	White
Rryywwss	Red
RryywwSs	Pink
RryywwSS	Purple
RrYyWWss	Orange
RrYyWWSs	Yellow
RrYyWWSS	Yellow
RrYyWwss	Red
RrYyWwSs	Pink
RrYyWwSS	White
RrYywwss	Red
RrYywwSs	Pink
RrYywwSS	Purple
RrYYWWss	Orange
RrYYWWSs	Yellow
RrYYWWSS	Yellow
RrYYWwss	Orange
RrYYWwSs	Yellow
RrYYWwSS	Yellow
RrYYwwss	Red
RrYYwwSs	Pink
RrYYwwSS	White
RRyyWWss	Black
RRyyWWSs	Red(seed)
RRyyWWSS	Pink
RRyyWwss	Black
RRyyWwSs	Red
RRyyWwSS	Pink
RRyywwss	Black
RRyywwSs	Red
RRyywwSS	Pink
RRYyWWss	Orange
RRYyWWSs	Orange
RRYyWWSS	Yellow
RRYyWwss	Red
RRYyWwSs	Red
RRYyWwSS	White
RRYywwss	Black
RRYywwSs	Red
RRYywwSS	Purple
RRYYWWss	Orange
RRYYWWSs	Orange
RRYYWWSS	Yellow
RRYYWwss	Orange
RRYYWwSs	Orange
RRYYWwSS	Yellow
RRYYwwss	Blue
RRYYwwSs	Red
RRYYwwSS	White